##############################
#............................#
#.######.###########.#######.#
#......#.............#.......#
#.####.#.#####.#####.#.#####.#
#....#.#.............#.#.....#
#.##.#.#.#####.#####.#.#.###.#
#....#.................#.....#
#.##.#.#.#.### ###.#.#.#.###.#
#......#.#.#!   @#.#.#.#.###.#
#.##.#.#.#.#     #.#.#.......#
#.##.#.#.#.#######.#.#.#.###.#
#....#.................#.....#
#.##.#.#.#####.#####.#.#.###.#
#....#.#.............#.#.....#
#.####.#.#####.#####.#.#####.#
#......#.............#.......#
#.######.###########.#######.#
#............................#
##############################