#############################
#*.!..................!....*#
#.######.###########.######.#
#.....*#.............#*.....#
#.####.#.#####!#####.#.####.#
#....#.#.............#.#....#
#.##.#.#.#####.#####.#.#.##.#
#....#.................#....#
#.##.#.#.#.### ###.#.#.#.##.#
#......#.#.# ! ! #.#.#.#.##.#
#.##.#.#.#.# ! ! #.#.#......#
#.##.#.#.#.#######.#.#.#.##.#
#....#.................#....#
#.##.#.#.#####.#####.#.#.##.#
#....#.#......!......#.#....#
#.####.#.#####.#####.#.####.#
#.....*#......!......#*.....#
#.######.###########.######.#
#*............@............*#
#############################