##############################
#*..........................*#
#.######.###########.#######.#
#.....*#.............#*......#
#.####.#.#####.#####.#.#####.#
#...*#.#.............#.#*....#
#.##.#.#.#####.#####.#.#.###.#
#....#.................#.....#
#.##.#.#.#.### ###.#.#.#.###.#
#......#.#.#!   @#.#.#.#.###.#
#.##.#.#.#.#* .  #.#.#.......#
#.##.#.#.#.#######.#.#.#.###.#
#....#.................#.....#
#.##.#.#.#####.#####.#.#.###.#
#...*#.#.............#.#*....#
#.####.#.#####.#####.#.#####.#
#.....*#.............#*......#
#.######.###########.#######.#
#*..........................*#
##############################