##############################
#!..........................*#
#.######.###########.#######.#
#.....*#.............#*......#
#.####.#.#####.#####.#.#####.#
#...*#.#.............#.#*....#
#.##.#.#.#####.#####.#.#.###.#
#....#.................#.....#
#.##.#.#.#.### ###.#.#.#.###.#
#......#.#.#     #.#.#.#.###.#
#.##.#.#.#.#  *  #.#.#.......#
#.##.#.#.#.#######.#.#.#.###.#
#....#.................#.....#
#.##.#.#.#####.#####.#.#.###.#
#...*#.#.............#.#*....#
#.####.#.#####.#####.#.#####.#
#.....*#.............#*......#
#.######.###########.#######.#
#*..........................@#
##############################